111111111111111
1P00000000000E1
111011101110111
100010001000001
101110111011101
100010C00100001
111011101110111
100010001000C01
101110111011101
10C000000000001
111111111111111
