1111111111111111111111111
1I00000000000000000000001
1000000000000000000000001
10C0C0C0C0C0C0C0C0C0C0C01
100C0C0C0C0C0C0C0C0C0C0C1
10C0C0C0C0C0C0C0C0C0C0C01
1000000000000000000000001
1000000000000000000000001
1000000000000000000000001
1000000000000000000000001
1P000000000000000000000E1
1111111111111111111111111