11111111111111111
1ECCCCCCCCCCCCCC1
11111111111111101
10000000000000001
10000000000000001
10000000000000001
1P0000CCCCCCCCCC1
11111111111111111