111111111111111111111111111111111
1I1C00CCCCCCCCCC001C00010000000E1
101C101111111111001C1001000000001
101C10CCCCCCCCCC001C1001000000001
101C101111111111001C1000000000001
101C10CCCCCCCCCC001C1001CCCCCCCC1
101C101111111111001C1001CCCCCCCC1
1P0010000000000000001001CCCCCCCC1
111111111111111111111111111111111