1111111111111111111111111111111111111111111111111111111111
1P       1     1  11   1  W W W W W W11111   11         C1
1               C1   1  W W W W CW W 111C       11111111 1
1  111   1 11  1   1     W W W W W W 111  22   1       1 1
1  1              111                11  2222  1 1111  1 1
1  1  22 2  2      1     22   S      1        11C   1  1 1
1    2 2 2   2 1   1     C S S  2    1 111111   1 11  1  1
1    222 22   C1   1         22      1 1 C 1  C    1 1  11
1  1  22 2     1   1G G              1 1 1 1 11 111  1   1
1  1        1  1   1G G G G G  C       1 1          1  1 1
1  111 1 11111 1   1G GCG G G 22     1 1 111111111111 11 1
1      C           1G G 1G G G       1 1            C    1
11111111111111111111111111111111111111111111111111111111 1
1C         1       1GGG           1 C1         1         1
1 111 1111 1C1 111 1GGG 22           1 2  2  2C  2 22 1111
1 C    S           1  22    22       1  2  2  2     2C   1
1 111 1111 1 1 11111           SSS   11  2  2   B 2  22  1
1 1      1 1   S   1       22  SSS   1    2   2 22  2  2 1
1 1 1 11 1 1 1 111          C      2 1 22  B 2C 22    2  1
1 E C S  1 1     1 1            22   1   2  2  222   2  11
1 1 1 1111 1 1 1 1 1    22     2 2   1 22 2 C2      B  1C1
1 1              1 1   22  2               22   22   2   1
1 1 1 111111 1 1C1 1                 1 2            222  1
1   1   S    1     1                 1    11  1          1
1111111111111111111111111111111111111111111111111111111111
