2222222222222
20C20000000C2
200002000C002
2P0C02E000022
2222222220222
2202202000222
2202202022022
220000200B022
22222B2022222
222220B000022
2222222222222
2222222222222
