11111111111111111111111111
1 C1       C11 C1    1  C1
1    1   C  1     1   C  1
1P C 1  1     1    E     1
111111111 111111111111 111
11 11 1         11 1   111
11 11 1 11 11 1 11 1 11 11
11    1    11 1    1    11
11111 1 11111 1111 1 11111
11111      11 1111      11
11111111 1SSSSCSSSSSS11111
11111111111111111111111111
