1111111111111111111
1   L  C  C  C  C 1
11111111111111111 1
1    C  C  C  C  C1
1 111 11111111111 1
1    C  C  E      1
11111111111111111 1
1   1     1       1
1 1   111  11  1111
1 1111   1   1    1
1      1  11 1111 1
1111 111   1  1 1 1
1   1   11  1   1 1
1P1   1    1  1   1
1111111111111111111
