111111111111111111111111111111111111111
1P              1    C                1
1   22222222222   2   2222222222222   1
1  2222   S         1          22222  1
1  2    1111111111 11 1111111      2  1
1  2  111C         1        111    2  1
1  2  1   11          1111    1  2 2  1
1  2 11   WWWW   2E 2 WWWW  1111   2  1
1  2  111        22 2       111  S 2  1
1  2  1   11    WWWW   111    1    2  1
1  2  111                  C111  2 2  1
1  2    111111111111111111111      2  1
1  2222     S             C    22222  1
1   2222222222222222222222222222222   1
1C            S    S                 C1
111111111111111111111111111111111111111
