111111111111111111111111111111
1P                          C1
1111111111111111111111111111 1
1C     1       B            C1
1C         B                 1
111111 11111111111111111111111
1C S      S       S    1    C1
1111111111111111111111 1 111 1
1            S            S C1
1 11111111111111111111   11111
1C             W W WW 111S SC1
11  22222      W W      1 S2S1
11  G GGGG       222   11S2S 1
111   GGG                 S C1
1111 1111111111111111 11111111
1221          E         B    1
111111111111111111111111111111
