1111111111111111111111111111111111
1P     1                 S S  S 11
1          S       22222222222   1
1               2222         22S 1
11             S       WWWWW    S1
1      2222222          WWWWW 22 1
1    222       22   2 WWWWW   C2 1
1   22   111                 222 1
1         C   11        222222  S1
1  22  GGGGG     111       S   111
1   2    2GGG   11211    S    1  1
1   222    1111112121       2    1
1 2     1111CB11111111      22 EC1
1   B1    C11   BB  B           11
1111111111111111111111111111111111
