11111
1PEC1
11111
1S  1
1   1
1  W1
11111
